0000000000000000000000000
0000000000111110000000000
0000000000100010000000000
0000000000102010000000000
0000000000100010000000000
0000000000100010000000000
0000000000100010000000000
0000000000100010000000000
0000111111100011111110000
0000100000000000000010000
0000102000000000002010000
0000100000000000000010000
0000111111111111111110000
0000000000000000000000000
0000000000000000000000000